000000000000000000000000000000000000000000000000000000000000000000000000000000000000000000000000000000000000000000000000000000000000000000000000000000
000000000000000000000000000000000000000000000000000000000000000000000000000000000000000000000000000000000000000000000000000000000000000000000000000000
000000000000000000000000000000000000000000000000000000000000000000000000000000000000000000000000000000000000000000000000000000000000000000000000000000
000000000000000000000000022200000002220000000000000000000000022200000000000000000000000000000000000000000000000000000000000000000000000000000000000000
000000000000000000000000000000000000000000000000000000000000000000000000000000000000000000000000000022222222220000000000000000000000000000000000000000
000000000000000000000000000000000000000022200000000002222000000000000000000000000000000000000000000000000000000000002220000000000000000000000000000000
000000000000000000000000000000000000000000000000000000000000000000000000000000000002222000000000000000000000000000000000000000000000000000000000000000
000000000000000000000000000002222000000000000222220000000000000000000000000002222000000000000000000000000000000000000000000020000000000000000000000000
000000000000000000000000000000111200000000000000000000000022222000000022220000000000000000000000000000000000000000000000000000000000000000000000000000
000000000000000000000000022222111122222222200000000000000211111200000000000000000000000000222222222222222222200000000000000000000000000000000000000000
222222222222222222222222211111111111111111122222222222222111111122222222222222222222222222111111111111111111122222222222222222222222222222222222222222
111111111111111111111111111111111111111111111111111111111111111111111111111111111111111111111111111111111111111111111111111111111111111111111111111111
111111111111111111111111111111111111111111111111111111111111111111111111111111111111111111111111111111111111111111111111111111111111111111111111111111
111111111111111111111111111111111111111111111111111111111111111111111111111111111111111111111111111111111111111111111111111111111111111111111111111111
111111111111111111111111111111111111111111111111111111111111111111111111111111111111111111111111111111111111111111111111111111111111111111111111111111
111111111111111111111111111111111111111111111111111111111111111111111111111111111111111111111111111111111111111111111111111111111111111111111111111111
111111111111111111111111111111111111111111111111111111111111111111111111111111111111111111111111111111111111111111111111111111111111111111111111111111
111111111111111111111111111111111111111111111111111111111111111111111111111111111111111111111111111111111111111111111111111111111111111111111111111111
